#########
#0000*00#
#0#####0#
#0000000#
#0#####0#
#0#####0#
#0&00000#
#########
